61 61
1111111111111111111111111111111011111111111111111111111111111
1000000000000000000010001000000000000000100000000000000000001
0110010010100000100000001010111011000110000011100110110111101
0000000000000000101000000010000000000010001000000000000000101
0001111111011010100110111111110111100110000010010001111110100
1000001000001000100010000000000000000000001000001000100000101
1010101001101010111010101110100010001110101110110010000011101
1000100000000010000010001010100010000000100010001000100000101
1001101110111110011110100010000000011010011000101010100000101
1000001000000010001000000010000000000000000000000000100000101
1010101010001011101100101110101010000111110111111110011110001
1000101000001000000000000000000000100000001000000010000000001
0010100101001011111110001111101010100111100011101110111100101
1000100000001000000000000000000010101010001000000000100000001
1010101110101110011001100111011011101000110010100010100110101
1010000010000010001010001000000000000000000010101000100010001
1010001011000011101010010011101011111011001110011001111011111
1010100000001000001010001010000010000000000000001000000000001
0011001111000111011011101011101110101010101011000100100111100
1010001000100000000000001000000000001000000000100010000000100
1010011010111111010111011011000000101111011010111010001010101
1000000000000000000010001000100000001000100010000000000000100
1001101001111011111000101101101010101000101010111010000110001
1000101000000010001010101000001000001000000000000000000010100
1010111011100010001010001010111001100010101101110110110010101
1000001010001010101000101000001000001010100010001000000010001
1011001010100011000101101111101011111010111000101010000001000
1000001010001000000000100000101000000010001000100000000000000
1011011110111100001010101010101011111000001011111100111110100
1010000000100000100010000000000010000010000000000010100000001
1001001000101011111111011011110010010000100011111000001110101
1010001000001010001000001000001000000010100000001000101000001
0000111100001010100010001001100010101000010110011010000111001
1010000010000010001000100010101010101010000010000000001000000
1010011000101010000000100110101010101011101010011000100011111
1010000010001000100000100000100010101000101000000000101000001
1010101010010011011111001011101010101000100011011111000111101
0010101010100010001000100010000000001000001000000000000000001
1011100000101100100010110010010110001011101110111001100011100
1000001000001000000000000000100010001000100000001000100010000
0110111011110010010010011110101011110110100010101110111110101
1000001000000000100010100000101000000010100010001000000000101
1011001010000001001010101011101010101110101110000001111001100
1010001000100010001000000000000010000000100000101000000000000
1011001111100010111111001001010010001010111100100110001110100
1000100010000000100000100000100010001010000000100000101000100
1010001010101011101001111101100110111010101111010111101011101
1010000010000000001000000000001000100000001000100000001000000
1010010011110001101000101100100111101110101000011100001100101
1000101010000000101010100000000010000000001010000000100000100
0011000000101100101000101111111010110010000010100001100110101
0010001010001010001010100000000010000010101000000010001000000
1010001000101011100010101000011000100000000010011100010010101
1010100000100010000010000010100010001000100000000010000010001
0010110111101010101111011010100011111000001100101011100010101
0000000000001000100000000000101000001000100010000000001000101
1001110000100011100110111011101111001000101000101010100101101
1000000010001000000010100000001000001000101000000000000010001
1010011010001100111010101010101110111001111000000111101010111
1000000000100000000000001010000000000000000000100000100000001
1111111111111111111111111111111011111111111111111111111111111

1 20
000B00000000000R0000
